#####################
#:::::::::#:::::::::#
#:###:###:#:###:###:#
#E# #:# #:#:# #:# #E#
#:###:###:#:###:###:#
#:::::::::::::::::::#
#:###:#:#####:#:###:#
#:###:#:#####:#:###:#
#:::::#:::#:::#:::::#
#####:### # ###:#####
    #:#       #:#    
#####:# ##### #:#####
     :  #   #  :     
#####:# ##### #:#####
    #:#       #:#    
#####:# ##### #:#####
#:::::::::#:::::::::#
#:###:###:#:###:###:#
#:::#:::::P:::::#:::#
###:#:#:#####:#:#:###
#:::::#:::#:::#:::::#
#:#######:#:#######:#
#:::::::::::::::::::#
#####################
